R, R, R, R, R, R, R, R, R
R, C-a, C, C, R, C, C, C, R
R, C, R, C, C, C, R, C, R
R, C, C, R, C-b, C, R, M, R
R, C, R, C, C, C, R, C, R
R, C, C, R, C, C, C, C, R
R, R, R, R, R, R, R, R, R