R, R, R, R, R, R, R
R, C, C, C, C, C, R
R, C, R, C, C, C, R
R, C, C-b, C-b, M, C, R
R, C, M, C, C, C, R
R, C-a, C, R, C, C, R
R, R, R, R, R, R, R