R, R, R, R, R,
R, C-a, C, C, R,
R, C, R, C, R,
R, C, C, C, R,
R, C, C, R, R,
R, C, C, M, R,
R, R, R, R, R,